Easy 22
1 1 1 1 1 1 1 1 1 1 1 1 1 1 1 1 1 1 1 1 1 1 
1 0 0 0 0 0 0 0 0 0 0 0 0 1 0 0 0 0 0 0 0 1 
1 0 0 0 0 0 0 0 0 0 0 0 0 1 0 0 0 0 0 0 0 1 
1 1 1 1 1 1 1 1 1 1 1 7 1 1 0 0 0 3 0 0 0 1 
1 0 0 0 0 0 0 0 0 0 0 0 0 7 0 0 0 0 0 0 0 1 
1 0 0 0 0 0 0 0 0 0 0 0 0 1 0 0 0 0 0 0 0 1 
1 0 0 0 0 0 0 0 0 0 0 0 0 1 0 0 0 0 0 0 0 1 
1 0 0 0 0 0 0 0 0 0 0 0 0 1 0 0 0 0 0 0 0 1 
1 0 0 0 0 0 0 0 0 1 1 7 1 1 1 1 1 1 0 0 0 1 
1 1 1 1 1 1 1 7 1 1 0 0 0 1 0 0 0 1 0 0 0 1 
1 0 0 0 0 0 1 0 0 1 0 0 0 1 0 0 0 1 0 0 0 1 
1 0 0 0 0 0 1 0 0 1 0 0 0 7 0 0 0 7 0 0 0 1 
1 0 0 0 0 0 1 0 0 1 0 0 0 1 0 0 0 1 1 1 1 1 
1 0 0 2 0 0 7 0 0 1 0 0 0 1 0 0 0 1 1 1 1 1 
1 0 0 0 0 0 1 0 0 1 7 1 1 1 1 1 1 1 1 1 1 1 
1 0 0 0 0 0 1 0 0 0 0 0 0 0 0 0 0 0 1 1 1 1 
1 0 0 0 0 0 1 0 0 0 0 0 0 0 0 0 0 0 1 1 1 1 
1 0 0 0 0 0 1 0 1 7 1 1 0 0 0 0 0 0 1 1 1 1 
1 0 0 0 0 0 1 0 1 0 0 1 0 0 0 0 0 0 1 1 1 1 
1 1 1 1 1 1 1 7 1 0 0 1 0 0 0 0 0 0 1 1 1 1 
1 4 0 0 0 0 0 0 1 0 0 1 0 0 0 0 0 0 1 1 1 1 
1 1 1 1 1 1 1 1 1 1 1 1 1 1 1 1 1 1 1 1 1 1 
level2 22
1 1 1 1 1 1 1 1 1 1 1 1 1 1 1 1 1 1 1 1 1 1 
1 0 0 0 0 0 0 0 0 0 0 0 0 0 0 0 0 0 0 0 0 1 
1 0 0 1 1 1 1 1 1 1 1 1 1 1 1 1 1 1 1 1 0 1 
1 0 0 1 0 0 0 0 0 0 0 1 0 0 0 0 0 0 0 1 2 1 
1 0 0 1 0 0 0 0 0 0 0 1 0 0 0 0 0 0 0 1 0 1 
1 0 0 1 0 0 0 0 0 0 0 1 0 0 0 0 0 0 0 1 0 1 
1 0 0 1 0 0 0 0 0 0 0 1 0 0 0 0 0 0 0 1 0 1 
1 0 0 1 0 0 0 0 0 0 0 1 0 0 0 0 0 0 0 1 0 1 
1 1 0 1 0 0 0 0 0 0 0 1 0 0 0 0 0 0 0 1 0 1 
1 1 0 7 0 0 0 0 0 0 0 7 0 0 0 0 0 0 0 7 0 1 
1 1 0 1 0 0 0 0 0 0 0 1 0 0 0 0 0 0 0 1 0 1 
1 1 0 1 0 0 0 0 0 0 0 1 0 0 0 0 0 0 0 1 0 1 
1 1 0 1 1 1 1 1 1 1 1 1 1 1 1 1 1 1 1 1 0 1 
1 1 0 6 0 0 0 0 0 0 0 0 0 0 0 0 0 0 0 0 0 1 
1 1 0 1 1 1 1 1 1 1 1 1 1 1 1 1 1 1 1 1 7 1 
1 1 0 7 0 0 0 0 0 0 0 0 0 0 0 0 0 0 0 0 0 1 
1 1 1 1 0 0 0 0 0 0 0 0 0 0 0 0 0 0 0 0 0 1 
1 0 0 0 0 0 0 0 0 0 0 0 0 0 0 0 0 0 0 0 0 1 
1 0 0 0 0 0 0 0 0 0 0 0 0 0 0 0 0 0 0 0 0 1 
1 0 0 0 0 0 0 0 0 0 0 0 0 0 0 0 0 0 0 0 0 1 
1 0 0 0 0 0 0 0 0 0 0 0 0 0 0 0 0 0 0 0 0 1 
1 1 1 1 1 1 1 1 1 1 1 1 1 1 1 1 1 1 1 1 1 1 
level3 22
1 1 1 1 1 1 1 1 1 1 1 1 1 1 1 1 1 1 1 1 1 1 
1 0 7 0 0 0 1 0 0 0 0 0 7 0 0 0 0 0 0 0 5 1 
1 0 1 0 0 0 1 0 0 0 0 0 1 0 0 0 1 1 1 1 1 1 
1 0 1 0 0 0 1 0 0 0 0 0 1 0 0 0 1 0 0 0 6 1 
1 0 1 0 0 0 1 0 0 0 0 0 1 0 0 0 1 7 1 1 0 1 
1 0 1 0 0 0 1 0 0 0 0 0 1 0 0 0 1 0 1 1 0 1 
1 0 1 0 0 0 1 0 0 0 0 0 1 0 0 0 1 0 1 1 0 1 
1 0 1 0 0 0 1 0 0 0 0 0 1 0 0 0 7 0 1 1 0 1 
1 0 1 0 0 0 7 0 0 0 0 0 1 0 0 0 1 1 1 1 0 1 
1 0 1 0 0 0 1 0 0 0 0 0 7 0 0 0 1 1 1 1 0 1 
1 0 1 0 0 0 1 0 0 0 0 0 0 0 0 0 1 1 1 1 0 1 
1 0 1 0 0 0 1 0 1 1 1 1 1 7 1 1 1 1 0 0 7 1 
1 0 1 0 0 0 1 0 7 0 0 0 0 0 0 0 0 1 0 0 0 1 
1 0 1 0 0 0 1 0 1 1 1 1 1 1 1 1 1 1 1 1 0 1 
1 0 1 0 0 0 7 0 0 0 0 0 0 0 0 0 0 0 0 7 0 1 
1 0 1 0 0 0 1 1 1 1 1 1 1 1 1 1 1 1 1 1 0 1 
1 0 1 0 0 0 0 0 0 0 0 0 0 0 0 0 0 0 0 0 0 1 
1 0 1 0 0 0 0 0 0 0 0 0 0 0 0 0 0 0 0 0 0 1 
1 0 1 0 0 0 0 0 0 0 0 0 0 0 0 0 0 0 0 0 0 1 
1 0 1 0 0 0 0 0 0 0 0 0 0 0 0 0 0 0 0 0 0 1 
1 3 1 0 0 0 0 0 0 0 0 0 0 0 0 0 0 0 0 0 0 1 
1 1 1 1 1 1 1 1 1 1 1 1 1 1 1 1 1 1 1 1 1 1 

Medium 22
1 1 1 1 1 1 1 1 1 1 1 1 1 1 1 1 1 1 1 1 1 1 
1 0 0 2 0 0 0 0 0 0 0 0 0 7 0 0 7 0 1 0 0 1 
1 0 0 0 0 0 0 0 0 0 0 0 0 1 0 0 1 0 1 0 0 1 
1 1 1 1 1 1 1 1 1 1 1 7 1 1 0 0 1 3 1 0 0 1 
1 0 0 0 0 0 0 0 0 0 0 0 0 7 0 0 1 7 1 0 0 1 
1 0 0 0 0 0 0 0 0 0 0 0 0 1 0 0 0 0 0 0 0 1 
1 7 1 1 1 1 1 0 0 0 0 0 0 1 0 0 0 0 0 0 0 1 
1 0 0 0 0 0 7 0 0 0 0 0 0 1 0 0 0 0 0 0 0 1 
1 0 0 0 0 0 1 0 0 1 1 7 1 1 1 1 1 1 1 7 1 1 
1 1 1 7 1 1 1 7 1 1 0 0 0 1 0 0 0 1 0 0 0 1 
1 0 0 0 0 0 1 0 0 1 0 0 0 1 0 0 0 1 0 0 0 1 
1 0 0 0 0 0 1 0 0 1 0 0 0 7 0 0 0 7 0 0 0 1 
1 1 1 0 1 7 1 0 0 1 0 0 0 1 0 0 0 1 1 0 1 1 
1 1 1 7 1 0 1 0 0 1 0 0 0 1 0 0 0 1 1 0 1 1 
1 0 0 0 1 0 1 1 7 1 7 1 1 1 1 1 1 1 1 0 1 1 
1 0 0 0 1 0 1 0 0 0 0 0 0 0 0 0 0 0 1 0 1 1 
1 0 0 0 1 0 1 0 0 0 0 0 0 0 0 0 0 0 7 0 1 1 
1 0 0 0 1 0 1 0 1 7 1 1 0 0 0 0 0 0 1 1 1 1 
1 0 0 0 1 0 1 0 1 0 0 1 0 0 0 0 0 0 1 1 1 1 
1 1 1 7 1 7 1 1 1 0 0 1 0 0 0 0 0 0 1 1 1 1 
1 4 0 0 0 0 0 0 7 0 0 1 0 0 0 0 0 0 1 1 1 1 
1 1 1 1 1 1 1 1 1 1 1 1 1 1 1 1 1 1 1 1 1 1 
level2 22
1 1 1 1 1 1 1 1 1 1 1 1 1 1 1 1 1 1 1 1 1 1 
1 0 0 6 0 0 0 7 0 0 0 7 0 0 0 0 0 0 0 0 0 1 
1 7 1 1 1 7 1 0 1 1 1 1 1 1 1 1 1 1 1 1 0 1 
1 0 1 0 0 0 1 0 1 0 7 0 0 0 0 0 0 0 0 7 0 1 
1 0 1 1 1 0 1 0 1 0 1 1 1 1 1 1 7 1 1 1 0 1 
1 0 1 1 1 0 1 0 1 0 1 0 0 0 0 1 0 1 0 1 0 1 
1 0 1 1 1 0 1 0 1 0 1 0 0 0 0 1 0 1 0 1 0 1 
1 0 1 1 1 0 1 0 1 0 1 0 0 1 1 0 0 1 0 1 0 1 
1 7 1 1 1 0 1 0 1 0 1 0 0 1 0 0 1 1 0 1 0 1 
1 0 0 7 1 0 1 0 1 0 1 0 0 1 0 1 0 1 0 7 0 1 
1 1 0 1 1 0 1 0 1 0 1 0 0 1 0 1 0 1 0 1 0 1 
1 1 0 1 1 0 7 0 7 0 1 0 0 7 0 0 0 0 0 1 0 1 
1 1 0 1 1 1 1 1 1 1 1 1 1 1 1 1 7 1 1 1 0 1 
1 1 0 0 0 0 0 0 0 0 0 0 0 0 0 0 0 0 0 0 0 1 
1 1 0 1 1 1 1 1 1 1 1 1 1 1 1 1 1 1 1 1 7 1 
1 1 0 7 0 0 0 0 1 0 0 0 0 1 0 0 0 0 0 0 0 1 
1 1 1 1 1 1 1 0 1 0 0 0 0 7 0 1 1 1 1 1 0 1 
1 0 0 0 1 0 0 0 1 0 2 0 0 1 0 1 0 1 0 1 0 1 
1 0 1 0 1 0 1 0 1 0 0 0 0 1 0 1 0 1 0 1 0 1 
1 0 1 0 7 0 1 0 7 0 0 0 0 1 0 1 0 1 0 1 0 1 
1 0 0 0 1 0 0 0 1 0 0 0 0 1 0 0 0 7 0 0 0 1 
1 1 1 1 1 1 1 1 1 1 1 1 1 1 1 1 1 1 1 1 1 1 
level3 22
1 1 1 1 1 1 1 1 1 1 1 1 1 1 1 1 1 1 1 1 1 1 
1 0 7 0 1 0 7 0 0 0 0 0 7 0 0 0 0 0 0 0 5 1 
1 0 1 0 1 0 1 0 1 7 1 0 1 0 1 0 1 1 1 1 1 1 
1 0 1 0 1 0 1 0 1 0 1 0 1 0 1 0 1 0 0 0 0 1 
1 0 1 0 1 0 1 0 1 0 1 0 1 0 0 0 1 7 1 1 7 1 
1 0 1 0 1 0 1 0 1 0 1 0 1 0 1 0 1 0 1 1 0 1 
1 0 1 0 1 0 1 0 1 0 1 0 1 0 1 0 1 0 1 1 0 1 
1 0 1 0 1 0 1 0 1 0 7 0 1 0 1 0 7 0 1 1 0 1 
1 0 1 0 1 0 7 0 1 0 1 0 0 0 0 0 1 1 1 1 0 1 
1 0 1 0 1 0 1 0 1 1 1 7 1 1 1 7 1 1 1 1 0 1 
1 0 1 0 7 0 1 0 0 0 0 0 0 0 0 0 1 1 1 1 0 1 
1 0 1 0 1 0 1 0 1 1 1 1 1 7 1 1 1 1 0 0 0 1 
1 0 1 0 1 0 1 0 7 0 0 0 0 0 0 0 0 1 0 0 0 1 
1 0 1 0 1 0 1 0 1 1 1 1 1 1 1 1 1 1 1 1 0 1 
1 0 1 0 1 0 7 0 0 0 7 0 0 0 0 0 0 0 0 7 0 1 
1 0 1 0 1 0 1 1 1 1 0 1 1 1 1 1 1 1 1 1 0 1 
1 0 1 0 1 0 0 1 0 0 0 0 0 1 0 0 0 0 0 0 0 1 
1 0 1 0 1 0 0 7 0 0 6 0 0 7 0 1 1 1 1 1 0 1 
1 0 1 0 1 0 0 1 0 0 0 0 0 1 0 1 1 1 1 1 0 1 
1 0 1 0 1 0 0 1 1 1 7 1 1 1 0 1 1 1 1 1 7 1 
1 3 1 0 7 0 0 7 0 0 0 0 0 0 0 0 0 0 0 0 0 1 
1 1 1 1 1 1 1 1 1 1 1 1 1 1 1 1 1 1 1 1 1 1 

Hard 22
1 1 1 1 1 1 1 1 1 1 1 1 1 1 1 1 1 1 1 1 1 1 
1 0 7 0 1 0 1 0 0 0 0 0 7 0 1 0 1 0 0 0 2 1 
1 0 1 0 1 0 1 0 1 1 1 1 1 0 1 0 1 0 1 1 1 1 
1 0 1 0 1 0 1 0 1 0 0 0 1 0 1 0 7 0 0 0 0 1 
1 0 1 0 1 7 1 0 1 0 1 0 1 0 1 0 1 0 1 1 0 1 
1 0 1 0 1 0 1 0 1 1 1 0 1 0 1 0 1 0 1 1 0 1 
1 0 1 0 1 0 1 0 0 0 0 0 1 0 1 0 1 0 1 1 0 1 
1 0 1 0 1 0 1 0 1 1 1 1 1 0 1 0 1 0 0 7 0 1 
1 1 1 0 1 0 7 0 0 0 0 0 0 0 1 0 1 1 1 1 1 1 
1 7 1 0 1 0 1 1 1 1 1 1 1 7 1 0 0 0 0 0 0 1 
1 0 1 0 1 0 1 0 0 0 0 0 0 0 0 7 1 1 1 1 7 1 
1 0 1 0 1 0 1 0 1 1 1 1 1 1 1 1 1 1 0 0 0 1 
1 0 1 0 1 0 1 0 7 0 0 0 0 1 0 0 0 7 0 1 0 1 
1 0 1 0 1 0 1 0 1 1 1 1 1 1 1 1 1 1 1 1 0 1 
1 0 1 0 1 0 1 0 0 0 0 0 0 0 0 0 0 0 0 0 0 1 
1 0 1 0 1 0 1 1 1 1 1 1 1 1 1 1 1 1 1 1 1 1 
1 0 1 0 7 0 1 7 0 0 0 0 0 0 0 0 0 0 0 0 0 1 
1 0 1 0 1 1 1 1 1 1 1 1 1 1 1 1 1 1 7 1 1 1 
1 0 1 0 0 0 0 0 0 0 0 0 0 0 0 0 0 0 0 0 0 1 
1 0 1 1 1 1 1 1 1 1 1 1 1 1 1 1 1 1 1 1 7 1 
1 4 0 0 0 0 0 0 0 0 0 0 0 0 0 0 0 0 0 0 0 1 
1 1 1 1 1 1 1 1 1 1 1 1 1 1 1 1 1 1 1 1 1 1 
level2 22
1 1 1 1 1 1 1 1 1 1 1 1 1 1 1 1 1 1 1 1 1 1 
1 0 0 0 7 0 1 0 0 0 0 0 7 0 0 0 1 0 0 0 6 1 
1 0 0 0 1 0 1 0 1 1 1 1 1 0 1 0 1 0 1 1 1 1 
1 0 0 0 1 0 1 0 1 0 0 0 1 0 1 0 1 0 0 0 0 1 
1 0 0 0 1 0 1 0 1 0 1 0 1 0 1 0 1 7 1 1 7 1 
1 0 0 0 1 0 1 0 1 1 1 0 1 0 1 0 1 0 1 0 0 1 
1 0 0 0 1 0 7 0 0 0 0 0 1 0 1 0 1 0 1 1 0 1 
1 0 0 0 1 1 1 1 1 1 1 1 1 0 1 0 1 0 0 1 0 1 
1 0 0 0 7 0 1 0 0 0 0 0 0 0 1 0 1 1 1 1 0 1 
1 1 7 1 1 0 1 0 1 1 1 1 1 1 1 0 0 7 0 0 0 1 
1 0 0 0 1 0 1 0 0 0 0 7 0 0 0 0 0 1 1 1 7 1 
1 0 0 0 1 0 1 7 1 1 1 1 1 1 1 1 1 1 0 0 0 1 
1 0 0 0 1 0 1 0 1 0 0 0 0 0 0 0 0 1 0 1 0 1 
1 0 0 0 1 0 1 0 1 1 1 1 1 1 1 1 7 1 1 1 0 1 
1 0 0 0 1 0 1 0 0 0 0 0 0 0 0 0 0 0 0 1 0 1 
1 1 1 1 1 0 1 1 1 1 1 7 1 1 1 1 1 1 1 1 0 1 
1 0 0 0 1 0 0 0 0 0 1 0 0 0 0 1 0 0 0 0 0 1 
1 1 1 1 1 1 1 1 1 7 1 1 1 1 7 1 1 1 1 1 1 1 
1 0 0 0 0 0 0 0 1 0 1 0 0 0 0 0 0 0 0 0 0 1 
1 0 0 0 0 0 0 0 1 0 7 0 0 0 0 0 0 0 0 0 0 1 
1 0 0 2 0 0 0 0 7 0 1 0 0 0 0 0 0 0 0 0 0 1 
1 1 1 1 1 1 1 1 1 1 1 1 1 1 1 1 1 1 1 1 1 1 
level3 22
1 1 1 1 1 1 1 1 1 1 1 1 1 1 1 1 1 1 1 1 1 1 
1 0 1 0 7 0 1 0 0 0 0 1 1 0 7 0 1 0 0 0 5 1 
1 0 1 0 1 0 1 0 1 1 0 1 1 0 1 0 1 0 1 1 1 1 
1 0 1 0 1 0 1 0 1 1 0 1 1 0 1 0 1 0 0 0 1 1 
1 0 1 0 1 0 1 0 0 1 0 1 1 0 1 0 1 0 1 1 1 1 
1 0 7 0 1 0 1 1 1 1 0 1 1 0 1 0 1 0 1 0 0 1 
1 0 1 0 1 0 1 0 0 0 0 1 1 0 1 0 1 0 1 1 0 1 
1 0 1 0 1 0 1 0 1 1 1 1 1 0 1 0 1 0 0 1 0 1 
1 0 1 0 1 0 1 0 0 0 0 0 0 0 1 0 1 1 1 1 0 1 
1 0 1 0 1 0 1 0 1 1 1 1 1 1 1 0 0 0 0 0 0 1 
1 0 1 0 1 0 1 0 0 0 0 0 0 0 0 0 0 1 1 1 1 1 
1 0 1 0 1 0 1 0 1 1 1 1 1 0 1 1 1 1 0 0 0 1 
1 0 1 0 1 0 1 0 1 0 0 0 0 0 0 0 0 1 0 1 0 1 
1 0 1 0 1 0 1 0 1 1 1 1 1 1 1 1 1 1 1 1 0 1 
1 0 1 0 1 0 1 0 0 0 0 0 0 0 0 0 0 0 0 0 0 1 
1 0 1 0 1 0 1 7 1 1 1 1 1 1 1 1 1 1 1 1 7 1 
1 0 1 0 0 0 0 0 0 0 0 0 0 0 0 0 0 0 0 0 0 1 
1 0 1 0 1 1 1 0 1 1 1 1 1 1 1 1 1 1 1 1 1 1 
1 0 1 0 0 0 0 0 0 0 0 0 0 0 0 0 0 0 0 0 0 1 
1 7 1 1 1 1 1 1 1 1 1 1 1 1 1 1 1 1 1 1 7 1 
1 0 0 6 0 0 7 0 0 0 0 0 0 0 0 0 0 0 0 0 0 1 
1 1 1 1 1 1 1 1 1 1 1 1 1 1 1 1 1 1 1 1 1 1 